1111111111111
100100000P001
1000011111011
100011000E0C1
1111111111111
