1111111111111111111111
1P00000000000000000001
1011111110100000101001
1010010010101010001001
1C0000001C00C0000000C1
1000000010000000000001
1010010110100000101001
1010010010101010001001
1C0000000C00C0000000C1
1000000000000000000001
1010010100100000101001
1010010010101010001001
1C0000000C00C0000000C1
1000000000000000000001
1010010100100000101001
1010010010101010001001
1C0000000C00C0000000C1
1E00000000000000000001
1111111111111111111111