111111111
1P0000001
111111101
1C0000001
111110111
100000E01
111111111
