111111111111
1000000001
1011111111101
10000P000101
1011111110101
1C0000000001
111111111111
