111111111111
1P000000001P
1011111111101
1000000000101
1011111110101
1C0000000001
111111111111
